######################
........##############
#######.##############
#######.##############
#######.##############
#######.##############
#######.##############
###.....##############
###.#########........B
###...........########
######################
######################
######################