######################
hhhhhhh3#v#2hhhhh3####
#######v###v#####v####
#######v###v#####v####
#######v###v#####v####
#######v###v#####v####
#2hhhhh4###v#####v####
#v#########v#####v####
#1hhhhhhhhh4#####1hhhB
######################