######################
........###.......####
#######.###.#####.####
#######.###.#####.####
#######.###.#####.####
#######.###.#####.####
#.......###.#####.####
#.#########.#####.####
#...........#####....B
######################
######################
######################
######################