######################
...#....##############
##.#.##.##############
##...##.##############
#######.##############
#######.##############
#######.##############
#######.....##########
###########.########.B
######....#.########.#
######.##...########.#
######.######........#
######........########